4 3 3 3 3 3 3 2 -1 3 3 3 3 3 3 3 4
4 -1 -1 -1 -1 -1 -1 -1 -1 -1 -1 -1 -1 -1 -1 -1 4
4 0 1 0 1 0 1 0 1 0 1 0 1 0 1 4
4 1 0 1 0 1 0 1 0 1 0 1 0 1 0 4
4 0 1 0 1 0 1 0 1 0 1 0 1 0 1 4
4 1 0 1 0 1 0 1 0 1 0 1 0 1 0 4
4 0 1 0 1 0 1 0 1 0 1 0 1 0 1 4
4 1 0 1 0 1 0 1 0 1 0 1 0 1 0 4
4 0 1 0 1 0 1 0 1 0 1 0 1 0 1 4
4 1 0 1 0 1 0 1 0 1 0 1 0 1 0 4
6 6 6 6 6 6 6 7 7 6 6 6 6 6 6 6
6 6 6 6 6 6 6 7 7 6 6 6 6 6 6 6