4 3 9 9 9 9 13 -1 9 9 9 9 9 9 3 4
4 -1 9 9 9 9 -1 -1 9 9 9 9 9 9 -1 4
4 5 5 5 5 5 5 5 5 5 5 5 5 5 5 4
4 5 5 5 5 5 5 5 5 5 5 5 5 5 5 4
4 5 5 5 5 5 5 5 5 5 5 5 5 5 5 4
4 5 5 5 5 5 5 5 5 5 5 5 5 5 5 4
4 5 5 5 5 5 5 5 5 5 5 5 5 5 5 4
4 5 5 5 5 5 5 5 5 5 5 5 5 5 5 4
4 5 5 5 5 5 5 5 5 5 5 5 5 5 5 4
4 5 5 5 5 5 5 5 5 5 5 5 5 5 5 4
4 4 4 4 4 4 4 14 -1 4 4 4 4 4 4 4
-1 -1 -1 -1 -1 -1 4 -1 -1 4 -1 -1 -1 -1 -1 -1
