3 3 3 4 5 5 3 3 3 3 3 3 3 3 5 3
3 3 5 3 4 3 3 3 3 3 4 3 3 3 3 3
3 0 0 0 0 0 0 1 0 2 0 0 0 0 0 3
3 0 0 2 0 0 0 0 0 0 0 0 1 0 0 3
3 0 0 0 0 1 0 0 0 0 0 0 0 2 0 3
3 1 2 0 0 0 8 9 8 0 1 0 0 0 0 4
5 0 0 0 2 0 8 8 8 0 0 0 0 0 2 5
5 0 0 2 0 0 8 8 8 0 0 0 0 0 0 3
4 0 0 0 0 0 0 0 0 2 0 0 2 0 0 5
3 0 2 0 0 0 0 1 0 0 0 0 0 0 0 3
3 0 0 0 2 0 0 0 0 0 0 1 0 0 1 3
3 3 4 4 3 3 3 0 0 3 3 3 3 5 4 3
-------------------------------
0 0 0 11 0 0 0 11 0 0 0 11 0 0 0 0
0 0 0 0 0 0 0 0 0 0 0 0 0 0 0 0
0 0 0 0 0 0 0 0 0 0 0 0 0 0 0 0
0 0 0 0 0 0 0 0 0 0 0 12 0 0 0 0
0 0 0 0 0 0 0 0 0 0 0 0 0 0 0 0
0 0 0 0 0 0 0 0 0 0 0 0 0 0 13 0
0 0 13 0 0 0 0 0 0 0 0 0 0 0 0 0
0 0 0 0 0 0 0 0 0 0 0 0 0 0 0 0
0 0 0 0 0 0 0 0 0 0 0 0 0 0 0 0
0 0 13 0 0 0 0 0 0 0 0 0 0 0 0 0
0 0 0 0 0 0 0 0 0 0 0 0 13 0 0 0
0 0 0 0 0 0 0 0 0 0 0 0 0 0 0 0