0 0 0 0 0 0 0 0 0 0 0 0 0 0 0 0
0 0 0 0 0 0 0 0 0 0 0 0 0 0 0 0
0 6 7 6 7 6 7 6 7 6 7 6 7 6 7 0
0 7 6 7 6 7 6 7 6 7 6 7 6 7 6 0
0 6 7 6 7 6 7 6 7 6 7 6 7 6 7 0
0 7 6 7 6 7 6 7 6 7 6 7 6 7 6 0
0 6 7 6 7 6 7 6 7 6 7 6 7 6 7 0
0 7 6 7 6 7 6 7 6 7 6 7 6 7 6 0
0 6 7 6 7 6 7 6 7 6 7 6 7 6 7 0
0 7 6 7 6 7 6 7 6 7 6 7 6 7 6 0
0 6 7 6 7 6 7 6 7 6 7 6 7 6 7 0
0 0 0 0 0 0 0 7 6 0 0 0 0 0 0 0
-------------------------------
0 0 0 0 0 0 15 14 0 15 0 0 0 0 0 0
0 0 0 0 0 0 0 0 0 0 0 0 0 0 0 0
0 0 0 0 0 0 0 0 0 0 0 0 0 0 0 0
0 0 0 0 0 0 0 0 0 0 0 0 0 0 0 0
0 0 0 0 0 0 0 0 0 0 0 0 0 0 0 0
0 0 0 0 0 0 0 0 0 0 0 0 0 0 0 0
0 0 0 0 0 0 0 0 0 0 0 0 0 0 0 0
0 0 0 0 0 0 0 0 0 0 0 0 0 0 0 0
0 0 0 0 0 0 0 0 0 0 0 0 0 0 0 0
0 0 0 0 0 0 0 0 0 0 0 0 0 0 0 0
0 0 0 0 0 0 0 0 0 0 0 0 0 0 0 0
0 0 0 0 0 0 0 0 0 0 0 0 0 0 0 0