3 3 3 4 5 5 3 3 3 3 3 3 3 3 5 3
3 3 5 3 4 3 3 3 3 3 4 3 3 3 3 3
3 0 0 0 0 0 0 1 0 2 0 0 0 0 0 3
3 0 0 2 0 0 0 0 0 0 0 0 1 0 0 3
3 0 0 0 0 1 0 0 0 0 0 0 0 2 0 3
3 1 2 0 0 0 0 0 0 0 1 0 0 0 0 4
5 0 0 0 2 0 0 0 0 0 0 0 0 0 2 5
5 0 0 2 0 0 0 0 0 0 0 0 0 0 0 3
4 0 0 0 0 0 0 0 0 2 0 0 2 0 0 5
3 0 2 0 0 0 0 1 0 0 0 0 0 0 0 3
3 0 0 0 2 0 0 0 0 0 0 1 0 0 1 3
3 3 4 4 3 3 3 0 0 3 3 3 3 5 4 3
-------------------------------
0 0 16 17 0 0 0 19 0 0 0 17 0 16 0 0
0 0 0 0 0 0 0 0 0 0 0 0 0 0 0 0
0 0 0 0 0 0 0 0 0 0 0 0 0 0 0 0
0 0 0 0 0 0 0 0 0 0 0 0 0 0 0 0
0 0 0 0 0 0 18 0 0 0 0 0 0 0 0 0
0 0 0 0 0 0 0 0 0 0 0 0 0 0 13 0
0 0 13 0 0 0 0 0 0 0 0 0 0 0 0 0
0 0 0 0 0 0 0 0 0 0 0 0 0 0 0 0
0 0 0 0 0 0 0 0 0 0 0 0 0 0 0 0
0 0 13 0 0 0 0 0 0 0 0 0 0 0 0 0
0 0 0 0 0 0 0 20 0 0 0 0 13 0 0 0
0 0 0 0 0 0 0 0 0 0 0 0 0 0 0 0