4 4 4 4 4 4 4 4 4 4 4 4 4 4 4 4 4 4 4 4 4 4 4 4 4 4 4 4 4 4
4 4 4 4 4 4 4 4 4 4 4 4 4 4 4 4 4 4 4 4 4 4 4 4 4 4 4 4 4 4
4 4 4 4 4 4 4 4 4 4 4 4 4 4 4 4 4 4 4 4 4 4 4 4 4 4 4 4 4 4
4 4 4 4 4 4 4 4 4 4 4 4 4 4 4 4 4 4 4 4 4 4 4 4 4 4 4 4 4 4
4 0 1 0 2 0 0 1 0 0 0 2 0 1 0 0 2 0 0 0 1 0 0 0 2 0 0 1 0 4
4 0 0 2 0 0 1 0 0 3 0 0 0 0 1 0 0 0 2 0 0 1 0 0 0 0 2 0 0 4
4 1 0 0 0 0 0 0 2 0 0 1 0 0 0 2 0 0 0 0 1 0 0 3 0 0 0 0 1 4
4 0 2 0 0 1 0 0 0 0 1 0 0 2 0 0 0 1 0 0 0 0 2 0 0 1 0 0 0 4
4 0 0 0 1 0 0 2 0 0 0 0 2 0 0 1 0 0 0 3 0 0 0 0 1 0 0 2 0 4
4 1 0 0 0 2 0 0 0 1 0 0 0 0 1 0 0 2 0 0 0 1 0 0 0 2 0 0 0 4
4 0 0 3 0 0 0 1 0 0 0 2 0 0 0 0 1 0 0 0 2 0 0 1 0 0 0 0 0 4
4 0 1 0 0 2 0 0 0 1 0 0 0 2 0 0 0 0 1 0 0 0 2 0 0 0 1 0 3 4
4 2 0 0 0 0 1 0 0 0 0 1 0 0 0 2 0 0 0 0 1 0 0 0 0 1 0 0 0 4
4 0 0 1 0 0 0 0 2 0 0 0 0 1 0 0 0 0 2 0 0 0 0 1 0 0 0 0 2 4
4 0 2 0 0 0 1 0 0 0 2 0 0 0 0 1 0 0 0 3 4 4 4 4 4 4 4 4 4 4
4 4 4 4 4 4 4 4 4 4 4 4 4 4 4 4 0 1 0 2 4 4 4 4 4 4 4 4 4 4
4 4 4 4 4 4 4 4 4 4 4 4 4 2 0 0 1 0 0 0 4 4 4 4 4 4 4 4 4 4
4 4 4 4 4 4 4 4 4 0 1 0 2 0 0 3 0 0 1 0 4 4 4 4 4 4 4 4 4 4
4 4 4 4 4 4 4 4 4 2 0 0 0 1 0 0 2 0 0 0 4 0 1 0 2 0 0 1 0 4
4 4 4 4 4 4 4 4 4 0 0 3 0 0 4 4 4 4 4 4 4 2 0 0 0 0 2 0 0 4
4 4 4 4 4 4 4 4 4 1 0 0 2 0 0 1 0 0 2 0 0 0 1 0 0 3 0 0 1 4
4 0 1 0 2 0 0 4 4 0 3 0 0 0 2 0 0 0 1 0 2 0 0 1 0 0 0 0 2 4
4 2 0 0 0 1 0 4 4 1 0 0 2 0 0 1 0 3 0 0 0 0 0 0 2 0 0 1 0 4
4 0 0 3 0 0 0 1 0 0 1 0 0 4 4 4 4 4 4 4 4 0 1 0 0 0 2 0 0 4
4 1 0 0 2 0 0 0 2 0 0 0 1 4 4 4 4 4 4 4 4 2 0 0 3 0 0 1 0 4
4 0 0 0 0 1 0 0 4 4 0 2 0 0 1 4 4 4 4 4 4 0 0 1 0 0 0 0 2 4
4 2 0 1 0 0 3 0 4 4 1 0 0 0 0 0 4 4 4 4 4 4 4 4 4 4 4 4 4 4
4 0 0 0 0 2 0 0 4 4 4 4 0 2 0 1 0 0 4 4 4 4 4 4 4 4 4 4 4 4
4 1 0 0 1 0 0 0 4 4 4 4 1 0 0 0 3 0 4 4 4 4 4 4 4 4 4 4 4 4
4 4 4 4 4 4 4 4 4 4 4 4 4 4 0 2 0 1 0 4 4 4 4 4 4 4 4 4 4 4
-----------------------------------------------------------
14 9 9 9 9 9 9 9 9 9 9 9 9 9 9 9 9 9 9 9 9 9 9 9 9 9 9 9 9 12
7 0 0 0 37 48 0 0 37 0 0 0 0 52 64 0 0 0 52 0 0 0 37 48 0 0 37 0 0 8
7 0 0 0 0 0 0 0 0 0 0 0 0 0 0 0 0 0 0 0 0 0 0 0 0 0 0 0 0 8
7 0 0 0 0 0 0 0 0 0 0 0 0 0 0 0 0 0 0 0 0 0 0 0 0 0 27 26 49 8
7 0 0 0 0 0 0 0 0 0 0 0 0 0 0 0 0 0 0 0 0 0 0 0 49 0 0 0 0 8
7 0 0 0 0 0 0 0 0 0 0 0 0 0 0 0 0 0 0 0 0 0 0 0 0 0 49 49 0 8
7 0 0 49 0 0 0 0 0 0 0 0 0 0 0 0 0 0 0 0 0 0 0 0 0 0 0 0 0 8
7 0 0 0 0 0 0 0 0 0 0 0 0 0 0 0 0 0 0 0 0 0 0 0 0 0 0 0 0 8
7 0 0 0 0 0 0 0 0 0 0 0 0 0 0 0 0 0 0 0 0 0 0 0 0 0 0 0 0 8
7 0 0 0 0 0 49 0 0 0 0 0 0 0 0 0 0 0 49 0 0 0 0 0 0 0 0 0 0 8
7 0 0 0 0 0 0 0 0 0 0 0 0 0 0 0 0 49 49 0 0 0 0 0 0 0 0 0 0 8
7 0 0 0 0 0 0 0 0 0 0 0 0 0 0 0 0 0 0 0 0 0 0 0 0 0 0 0 0 8
7 0 0 0 0 0 0 0 0 0 0 0 0 0 0 0 0 0 0 0 0 0 0 0 0 0 0 0 0 8
7 0 0 0 0 0 0 0 0 0 0 0 0 0 0 0 0 0 0 0 0 0 0 0 0 0 0 0 0 8
7 0 0 41 0 0 0 0 0 0 0 0 0 0 0 0 0 0 0 0 9 9 9 9 9 9 9 9 9 12
14 9 9 9 9 9 9 9 9 9 9 9 9 9 9 9 0 0 0 0 0 51 0 49 45 0 0 0 51 8
7 0 0 0 0 0 0 0 0 0 0 0 0 0 0 49 0 0 0 0 0 0 0 0 0 0 0 0 0 8
7 0 0 0 31 0 0 0 0 0 0 0 0 0 0 0 0 0 0 0 0 0 0 0 0 0 0 0 0 8
7 49 0 0 0 0 0 0 0 0 0 0 0 0 0 0 0 0 0 0 0 0 0 0 0 0 0 0 0 8
7 37 0 0 49 0 0 0 0 0 0 0 0 0 0 0 0 0 0 0 0 0 0 0 0 0 0 0 0 8
7 0 0 0 38 0 0 0 0 0 0 0 0 0 0 0 0 0 0 0 0 0 0 0 0 0 0 0 0 8
7 0 0 0 0 0 0 0 0 0 0 0 0 0 0 0 0 0 0 0 0 0 0 0 0 0 26 0 0 8
7 0 0 0 0 0 0 0 0 0 0 0 0 0 0 0 0 0 0 0 0 0 0 0 0 0 0 27 0 8
7 0 40 0 0 0 0 0 0 0 0 0 0 73 0 0 0 0 0 0 0 0 0 0 0 0 0 0 0 8
7 0 0 0 0 0 0 0 0 0 0 0 0 0 0 0 0 0 0 0 0 0 0 0 0 0 0 0 0 8
7 0 0 0 0 0 49 0 0 0 0 0 0 0 0 0 0 0 0 0 0 0 0 0 49 0 0 0 0 8
7 32 0 0 0 0 49 49 0 0 0 0 0 0 0 0 0 0 0 0 0 0 49 49 0 0 0 0 0 8
7 0 0 0 0 0 0 0 0 0 0 0 0 0 0 0 0 0 0 0 0 0 49 0 0 0 0 0 0 8
7 0 41 0 0 0 0 0 0 0 0 0 0 0 0 0 0 0 0 0 0 0 0 0 0 0 0 0 0 8
13 10 10 10 10 10 10 10 10 10 0 0 0 0 0 0 0 0 0 10 10 10 10 10 10 10 10 10 10 11