4 4 4 4 4 4 4 4 4 4 4 4 4 4 4 4 4 4 4 4 4 4 4 4 4 4 4 4 4 4
4 4 4 4 4 4 4 4 4 4 4 4 4 4 4 4 4 4 4 4 4 4 4 4 4 4 4 4 4 4
4 4 4 4 4 4 4 4 4 4 4 4 4 4 4 4 4 4 4 4 4 4 4 4 4 4 4 4 4 4
4 4 4 4 4 4 4 4 4 4 4 4 4 4 4 4 4 4 4 4 4 4 4 4 4 4 4 4 4 4
0 0 0 0 0 0 0 0 0 0 0 0 0 0 0 0 0 0 0 0 0 0 0 0 0 0 0 0 0 0
0 0 43 43 44 44 43 43 44 44 43 43 44 44 43 43 44 44 43 43 44 44 43 43 44 44 43 43 0 0
0 0 43 43 44 44 43 43 44 44 43 43 44 44 43 43 44 44 43 43 44 44 43 43 44 44 43 43 0 0
0 0 44 44 43 43 44 44 43 43 44 44 43 43 44 44 43 43 44 44 43 43 44 44 43 43 44 44 0 0
0 0 44 44 43 43 44 44 43 43 44 44 43 43 44 44 43 43 44 44 43 43 44 44 43 43 44 44 0 0
0 0 43 43 44 44 43 43 44 44 43 43 44 44 43 43 44 44 43 43 44 44 43 43 44 44 43 43 0 0
0 0 43 43 44 44 43 43 44 44 43 43 44 44 43 43 44 44 43 43 44 44 43 43 44 44 43 43 0 0
0 0 44 44 43 43 44 44 43 43 44 44 43 43 44 44 43 43 44 44 43 43 44 44 43 43 44 44 0 0
0 0 44 44 43 43 44 44 43 43 44 44 43 43 44 44 43 43 44 44 43 43 44 44 43 43 44 44 0 0
0 0 43 43 44 44 43 43 44 44 43 43 44 44 43 43 44 44 43 43 44 44 43 43 44 44 43 43 0 0
0 0 43 43 44 44 43 43 44 44 43 43 44 44 43 43 44 44 43 43 44 44 43 43 44 44 43 43 0 0
0 0 44 44 43 43 44 44 43 43 44 44 43 43 44 44 43 43 44 44 43 43 44 44 43 43 44 44 0 0
0 0 44 44 43 43 44 44 43 43 44 44 43 43 44 44 43 43 44 44 43 43 44 44 43 43 44 44 0 0
0 0 43 43 44 44 43 43 44 44 43 43 44 44 43 43 44 44 43 43 44 44 43 43 44 44 43 43 0 0
0 0 43 43 44 44 43 43 44 44 43 43 44 44 43 43 44 44 43 43 44 44 43 43 44 44 43 43 0 0
0 0 44 44 43 43 44 44 43 43 44 44 43 43 44 44 43 43 44 44 43 43 44 44 43 43 44 44 0 0
0 0 44 44 43 43 44 44 43 43 44 44 43 43 44 44 43 43 44 44 43 43 44 44 43 43 44 44 0 0
0 0 43 43 44 44 43 43 44 44 43 43 44 44 43 43 44 44 43 43 44 44 43 43 44 44 43 43 0 0
0 0 43 43 44 44 43 43 44 44 43 43 44 44 43 43 44 44 43 43 44 44 43 43 44 44 43 43 0 0
0 0 44 44 43 43 44 44 43 43 44 44 43 43 44 44 43 43 44 44 43 43 44 44 43 43 44 44 0 0
0 0 44 44 43 43 44 44 43 43 44 44 43 43 44 44 43 43 44 44 43 43 44 44 43 43 44 44 0 0
0 0 43 43 44 44 43 43 44 44 43 43 44 44 43 43 44 44 43 43 44 44 43 43 44 44 43 43 0 0
0 0 43 43 44 44 43 43 44 44 43 43 44 44 43 43 44 44 43 43 44 44 43 43 44 44 43 43 0 0
0 0 44 44 43 43 44 44 43 43 44 44 43 43 44 44 43 43 44 44 43 43 44 44 43 43 44 44 0 0
0 0 44 44 43 43 44 44 43 43 44 44 43 43 44 44 43 43 44 44 43 43 44 44 43 43 44 44 0 0
0 0 0 0 0 0 0 0 0 0 0 0 0 0 0 0 0 0 0 0 0 0 0 0 0 0 0 0 0 0
-----------------------------------------------------------
14 9 9 9 9 9 9 9 9 9 9 9 9 9 9 9 9 9 9 9 9 9 9 9 9 9 9 9 9 12
7 0 0 0 37 45 0 0 37 0 0 0 52 37 16 0 0 37 52 0 0 0 37 46 0 0 37 0 0 8
7 0 38 0 0 0 0 0 0 0 38 0 0 0 0 0 0 0 0 38 0 0 0 0 0 0 0 0 0 8
7 0 0 0 0 0 0 0 0 0 0 0 0 0 0 0 0 0 0 0 0 0 0 0 0 0 27 26 49 8
7 0 0 0 0 0 0 0 0 0 0 0 0 0 0 0 0 0 0 0 0 0 0 0 49 0 0 0 0 8
7 0 0 0 0 0 0 0 0 0 0 0 0 0 0 0 0 0 0 0 0 0 0 0 0 0 49 49 0 8
7 0 0 49 0 0 0 0 0 0 0 0 0 0 0 0 0 0 0 0 0 0 0 0 0 0 0 0 0 8
7 0 0 0 0 0 0 0 0 0 0 0 0 0 0 0 0 0 0 0 0 0 0 0 0 0 0 0 0 8
7 0 0 0 0 0 0 0 0 0 0 0 0 0 0 0 0 0 0 0 0 0 0 0 0 0 0 0 0 8
7 0 0 0 0 0 49 0 0 0 0 0 0 0 0 0 0 0 0 0 0 0 0 0 0 0 0 0 0 8
7 0 0 0 0 0 0 0 0 0 0 0 0 0 0 0 0 49 0 0 0 0 0 0 0 0 0 0 0 8
7 51 0 0 0 0 0 0 0 0 0 0 0 0 0 0 0 0 0 0 0 0 0 0 0 0 0 0 51 8
7 0 0 0 0 0 0 0 0 0 0 0 0 0 0 0 0 0 0 0 0 0 0 0 0 0 0 0 0 8
7 0 0 0 0 0 0 0 0 0 0 0 0 0 0 0 0 0 0 0 0 0 0 0 0 0 0 0 0 8
7 0 0 0 0 0 0 0 0 0 0 0 0 0 0 0 0 0 0 0 0 0 0 0 0 0 0 0 0 8
7 0 0 0 0 0 0 0 0 0 0 0 0 0 0 0 0 0 0 0 0 0 0 49 0 0 0 0 0 8
7 50 0 0 0 0 0 0 0 0 0 0 0 0 0 49 0 0 0 0 0 0 0 0 0 0 0 0 0 8
7 0 0 0 0 0 0 0 0 0 0 0 0 0 0 0 0 0 0 0 0 0 0 0 0 0 0 0 0 8
7 49 0 0 0 0 0 0 0 0 0 0 0 0 0 0 0 0 0 0 0 0 0 0 0 0 0 0 0 8
7 0 0 0 49 0 0 0 0 0 0 0 0 0 0 0 0 0 0 0 0 0 0 0 0 0 50 0 0 8
7 0 0 0 0 0 0 0 0 0 0 0 0 0 0 0 0 0 0 0 0 0 0 0 0 0 0 0 0 8
7 0 0 0 0 0 0 0 0 0 0 0 0 0 0 0 0 0 0 0 0 0 0 0 0 0 0 0 0 8
7 0 0 0 0 0 0 0 0 0 0 0 0 0 0 0 0 0 0 0 0 0 0 0 0 0 0 0 0 8
7 51 0 0 0 0 0 0 0 0 0 0 0 0 0 0 0 0 0 0 0 0 0 0 0 0 0 0 51 8
7 0 0 0 0 0 0 0 0 0 0 0 0 0 0 0 0 0 0 0 0 0 0 0 0 0 0 0 0 8
7 0 0 0 0 0 0 0 0 0 0 0 0 0 0 0 0 0 0 0 0 0 0 0 49 0 0 0 0 8
7 32 0 0 0 0 0 0 0 0 0 0 0 0 0 0 0 0 0 0 0 0 49 49 0 0 0 0 0 8
7 0 0 0 0 0 0 0 0 0 0 0 51 0 0 0 0 0 51 0 0 0 49 0 0 0 0 0 0 8
7 0 41 0 0 0 0 0 0 0 0 0 0 0 0 0 0 0 0 0 0 0 0 0 0 0 0 0 0 8
13 10 10 10 10 10 10 10 10 10 10 10 0 0 0 0 0 0 0 10 10 10 10 10 10 10 10 10 10 11