25 25 25 25 25 25 25 25 25 25 25 25 25 25 25 25 25 25 25 25 25 25 25 25 25 25 25 25 25 25
25 25 25 25 25 25 25 25 25 25 25 25 25 25 25 25 25 25 25 25 25 25 25 25 25 25 25 25 25 25
3 3 3 3 3 3 3 3 3 3 3 3 3 3 3 3 3 3 3 3 3 3 3 3 3 3 3 3 3 3
3 3 3 3 3 3 3 3 3 3 3 3 3 3 3 3 3 3 3 3 3 3 3 3 3 3 3 3 3 3
25 25 3 3 4 4 4 4 4 4 4 4 4 4 4 4 4 4 4 4 4 4 4 4 4 4 3 3 25 25 
25 25 3 3 4 0 0 0 0 0 0 0 0 0 0 0 0 0 0 0 0 0 0 0 4 4 3 3 25 25 
25 25 3 3 4 0 0 0 0 0 0 0 0 0 0 0 0 0 0 0 0 0 0 0 4 4 3 3 25 25 
25 25 3 3 4 0 0 0 0 0 0 0 0 0 0 0 0 0 0 0 0 0 0 0 4 4 3 3 25 25 
25 25 3 3 4 0 0 0 0 0 0 0 0 0 0 0 0 0 0 0 0 0 0 0 4 4 3 3 25 25 
25 25 3 3 4 4 4 4 4 4 4 4 4 4 4 4 4 4 4 4 4 4 4 4 4 4 3 3 25 25 
25 25 3 3 4 3 3 3 3 3 3 3 3 3 3 3 3 3 3 3 3 3 3 3 4 4 3 3 25 25 
25 25 3 3 4 3 3 3 3 3 3 3 3 3 3 3 3 3 3 3 3 3 3 3 4 4 3 3 25 25 
25 25 3 3 4 3 4 4 4 4 4 4 4 4 4 4 4 4 4 4 4 4 3 3 4 4 3 3 25 25 
25 25 3 3 4 3 4 0 0 0 0 0 0 1 0 2 0 0 0 0 0 3 3 3 4 4 3 3 25 25 
25 25 3 3 4 3 4 0 0 2 0 0 0 0 0 0 0 0 0 1 0 0 3 3 4 4 3 3 25 25 
25 25 3 3 4 3 4 0 0 0 0 1 0 0 0 0 0 0 0 0 2 0 3 3 4 4 3 3 25 25 
25 25 3 3 4 3 4 1 2 0 0 0 8 8 8 0 1 0 0 0 0 4 3 3 4 4 3 3 25 25 
25 25 3 3 4 3 4 0 0 0 2 0 8 8 9 0 0 0 0 0 2 5 3 3 4 4 3 3 25 25 
25 25 3 3 4 3 4 0 0 2 0 0 8 8 8 0 0 0 0 0 0 3 3 3 4 4 3 3 25 25 
25 25 3 3 4 3 4 0 0 0 0 0 0 0 0 2 0 0 2 0 0 5 3 3 4 4 3 3 25 25 
25 25 3 3 4 3 4 0 2 0 0 0 0 1 0 0 0 0 0 0 0 0 3 3 4 4 3 3 25 25 
25 25 3 3 4 3 3 0 0 0 2 0 0 0 0 0 0 0 1 0 0 1 3 3 4 4 3 3 25 25 
25 25 3 3 4 0 0 0 0 0 0 0 0 0 0 0 0 0 0 0 0 0 0 0 4 4 3 3 25 25 
25 25 3 3 4 0 0 0 0 0 0 0 0 0 0 0 0 0 0 0 0 0 0 0 4 4 3 3 25 25 
25 25 3 3 4 0 0 0 0 0 0 0 0 0 0 0 0 0 0 0 0 0 0 0 4 4 3 3 25 25 
25 25 3 3 4 4 4 4 4 4 4 4 4 4 4 4 4 3 3 0 0 3 3 4 4 4 3 3 25 25 
25 25 25 25 25 25 25 25 25 25 25 25 3 3 0 0 3 3 25 25 25 25 25 25 25 25 25 25 25 25
25 25 25 25 25 25 25 25 25 25 25 25 3 3 0 0 3 3 25 25 25 25 25 25 25 25 25 25 25 25
25 25 25 25 25 25 25 25 25 25 25 25 3 3 0 0 3 3 25 25 25 25 25 25 25 25 25 25 25 25
25 25 25 25 25 25 25 25 25 25 25 25 3 3 0 0 3 3 25 25 25 25 25 25 25 25 25 25 25 25