24 22 24 24 24 24 22 24 24 24 24 24 24 24 24 24
24 24 24 24 22 24 24 24 24 22 22 22 24 24 24 24
22 6 6 7 7 6 6 7 7 6 6 7 7 6 6 24
22 6 6 7 7 6 6 7 7 6 6 7 7 6 6 24
24 7 7 6 6 7 7 6 6 7 7 6 6 7 7 22
24 7 7 6 6 7 7 6 6 7 7 6 6 7 7 22
24 6 6 7 7 6 6 7 7 6 6 7 7 6 6 23
22 6 6 7 7 6 6 7 7 6 6 7 7 6 6 24
23 7 7 6 6 7 7 6 6 7 7 6 6 7 7 23
23 7 7 6 6 7 7 6 6 7 7 6 6 7 7 22
24 6 6 7 7 6 6 7 7 6 6 7 7 6 6 24
24 23 24 24 22 22 24 7 7 24 24 22 23 23 24 24
-------------------------------
0 0 0 0 0 0 15 14 0 15 0 0 0 0 0 0
0 0 0 0 0 0 0 0 0 0 0 0 0 0 0 0
0 0 0 0 0 0 0 0 0 0 0 0 0 0 0 0
0 0 0 0 0 0 0 0 0 0 0 0 0 0 0 0
0 0 0 0 0 0 0 0 0 0 0 0 0 0 0 0
0 0 0 0 0 0 0 0 0 0 0 0 0 0 0 0
0 0 0 0 0 0 0 0 0 0 0 0 0 0 0 0
0 0 0 0 0 0 0 0 0 0 0 0 0 0 0 0
0 0 0 0 0 0 0 0 0 0 0 0 0 0 0 0
0 0 0 0 0 0 0 0 0 0 0 0 0 0 0 0
0 0 0 0 0 0 0 0 0 0 0 0 0 0 0 0
0 0 0 0 0 0 0 0 0 0 0 0 0 0 0 0