4 4 4 4 4 4 4 4 4 4 4 4 4 4 4 4 4 4 4 4 4 4 4 4 4 4 4 4 4 4
4 4 4 4 4 4 4 4 4 4 4 4 4 4 4 4 4 4 4 4 4 4 4 4 4 4 4 4 4 4
4 4 4 4 4 4 4 4 4 4 4 4 4 4 4 4 4 4 4 4 4 4 4 4 4 4 4 4 4 4
4 4 4 4 4 4 4 4 4 4 4 4 4 4 4 4 4 4 4 4 4 4 4 4 4 4 4 4 4 4
4 4 4 4 4 4 4 4 4 4 4 4 4 4 4 4 4 4 4 4 4 4 4 4 4 4 4 4 4 4
4 4 4 4 4 4 4 4 4 4 4 4 4 4 4 4 4 4 4 4 4 4 4 4 4 4 4 4 4 4
0 1 0 2 0 0 1 0 0 0 2 0 1 0 0 2 0 0 0 1 0 0 0 2 0 0 1 0 0 0
0 0 2 0 0 1 0 0 3 0 0 0 0 1 0 0 0 2 0 0 1 0 0 0 0 2 0 0 0 1
1 0 0 0 0 0 0 2 0 0 1 0 0 0 2 0 0 0 0 1 0 0 3 0 0 0 0 1 0 0
0 2 0 0 1 0 0 0 0 1 0 0 2 0 0 0 1 0 0 0 0 2 0 0 1 0 0 0 2 0
0 0 0 1 0 0 2 0 0 0 0 2 0 0 1 0 0 0 3 0 0 0 0 1 0 0 2 0 0 0
1 0 0 0 2 0 0 0 1 0 0 0 0 1 0 0 2 0 0 0 1 0 0 0 2 0 0 0 1 0
0 0 3 0 0 0 1 0 0 0 2 0 0 0 0 1 0 0 0 2 0 0 0 1 0 0 0 0 0 2
0 1 0 0 2 0 0 0 1 0 0 0 2 0 0 0 0 1 0 0 0 2 0 0 0 1 0 3 0 0
2 0 0 0 0 1 0 0 0 0 1 0 0 0 2 0 0 0 0 1 0 0 0 0 1 0 0 0 2 0
0 0 1 0 0 0 0 2 0 0 0 0 1 0 0 0 0 2 0 0 0 0 1 0 0 0 0 2 0 0
0 2 0 0 0 1 0 0 0 2 0 0 0 0 1 0 0 0 3 0 0 1 0 0 0 2 0 0 0 1
1 0 0 3 0 0 0 2 0 0 0 1 0 0 0 0 2 0 0 0 0 0 0 2 0 0 0 1 0 0
0 0 0 0 1 0 0 0 0 2 0 0 0 1 0 0 0 0 0 2 0 0 1 0 0 0 0 0 2 0
0 1 0 0 0 2 0 0 1 0 0 0 2 0 0 0 1 0 0 0 0 1 0 0 0 2 0 0 0 0
4 4 4 4 4 4 4 4 4 4 4 4 0 1 0 2 0 4 4 4 4 4 4 4 4 4 4 4 4 4
4 4 4 4 4 4 4 4 4 4 4 4 2 0 0 0 1 4 4 4 4 4 4 4 4 4 4 4 4 4
4 4 4 4 4 4 4 4 4 4 4 4 0 0 3 0 0 4 4 4 4 4 4 4 4 4 4 4 4 4
4 4 4 4 4 4 4 4 4 4 4 4 1 0 0 2 0 4 4 4 4 4 4 4 4 4 4 4 4 4
0 2 0 0 0 1 0 0 0 0 2 0 0 0 1 0 0 0 0 2 0 0 0 1 0 0 0 2 0 0
1 0 0 1 0 0 0 2 0 0 0 0 1 0 0 0 2 0 0 0 0 1 0 0 0 3 0 0 0 1
0 0 2 0 0 0 1 0 0 3 0 0 0 0 2 0 0 0 1 0 0 0 0 2 0 0 0 1 0 0
0 0 0 0 1 0 0 0 0 0 0 0 0 1 0 0 0 0 0 0 0 2 0 0 0 0 1 0 0 0
2 0 0 0 0 0 0 2 0 0 1 0 0 0 0 0 2 0 0 0 1 0 0 0 2 0 0 0 0 0
0 1 0 2 0 1 0 0 0 0 0 0 2 0 0 1 0 0 3 0 0 0 0 1 0 0 0 2 0 1
-----------------------------------------------------------
14 9 9 9 9 9 9 9 9 9 9 9 9 9 9 9 9 9 9 9 9 9 9 9 9 9 9 9 9 12
7 25 0 0 60 0 0 0 25 0 0 0 0 0 0 0 0 0 0 25 0 0 60 0 0 0 25 0 0 8
7 0 0 0 0 0 0 0 0 0 0 0 0 0 0 0 0 0 0 0 0 0 0 0 0 0 0 0 0 8
7 25 0 0 0 48 0 0 25 0 0 52 37 53 0 0 37 52 0 25 0 0 0 48 0 0 25 0 0 8
7 0 0 0 0 0 0 0 0 0 0 0 0 0 0 0 0 0 0 0 0 0 0 0 0 0 0 49 0 8
7 0 0 59 0 49 0 0 0 0 0 0 0 0 0 0 0 0 0 0 0 0 0 0 0 0 0 49 0 8
7 0 0 0 58 0 0 0 0 0 63 0 0 0 0 0 0 0 0 0 0 0 0 40 0 0 0 0 0 8
7 0 0 0 0 0 0 0 0 0 0 0 0 0 0 0 0 0 58 0 0 0 0 0 0 0 0 0 0 8
7 0 0 0 0 0 0 0 0 0 0 0 0 0 0 0 0 0 0 0 0 0 0 0 0 0 0 0 0 8
7 0 0 62 0 0 0 0 0 0 0 0 0 0 0 0 0 0 0 0 0 0 33 0 49 0 0 0 0 8
7 0 49 0 0 0 0 0 0 0 0 0 57 0 0 0 0 0 0 0 0 0 0 0 0 49 0 0 0 8
7 0 0 0 0 0 0 0 0 0 0 0 0 56 0 0 0 0 59 0 0 0 0 0 0 61 0 0 0 8
7 0 0 0 0 0 63 0 0 0 0 0 0 0 0 0 0 0 0 0 0 0 0 0 0 0 0 62 0 8
7 0 0 0 0 0 0 0 0 0 0 58 0 0 0 0 0 0 0 0 0 0 0 0 0 0 0 0 0 8
7 0 0 0 0 36 0 0 49 0 0 0 0 0 0 0 0 0 0 0 0 0 0 0 0 0 0 0 0 8
7 0 58 0 0 0 0 0 0 0 0 0 0 0 0 0 0 0 0 0 0 0 0 0 0 0 0 0 0 8
7 0 0 0 0 0 0 0 0 0 0 0 0 0 0 0 0 0 0 0 0 0 0 0 0 0 0 0 0 8
7 0 0 0 0 0 0 0 0 0 0 0 0 0 0 0 0 0 0 0 0 0 0 61 0 0 0 0 0 8
7 0 0 63 0 0 0 0 0 0 0 0 0 0 0 0 0 0 0 0 63 0 0 0 0 0 0 0 0 8
7 0 0 0 0 0 0 0 0 0 0 0 0 0 0 0 0 0 0 0 0 0 0 0 0 0 41 0 0 8
14 9 9 9 9 9 9 9 9 9 9 9 0 0 0 0 0 9 9 9 9 9 9 9 9 9 9 9 9 12
7 31 25 0 0 29 0 30 25 0 0 37 0 0 0 0 0 37 0 0 0 60 55 0 30 0 0 0 0 8
7 0 0 0 0 0 0 0 0 0 0 0 0 0 0 0 0 0 0 0 0 0 0 0 0 0 0 0 0 8
7 0 49 0 0 0 0 0 0 0 0 0 0 0 0 0 0 0 0 0 0 22 0 0 0 0 0 23 0 8
7 0 0 0 0 61 0 0 0 0 0 63 0 0 0 72 0 49 0 0 0 0 0 0 0 0 0 0 0 8
7 0 0 0 0 0 0 0 0 0 0 0 0 0 0 0 0 0 0 49 0 0 0 0 0 0 0 49 0 8
7 0 0 58 0 0 0 0 0 0 0 0 0 0 0 0 0 0 0 0 0 0 0 0 0 59 0 0 0 8
7 0 0 0 0 58 0 0 0 0 0 0 37 54 0 0 37 0 0 0 0 61 0 0 0 0 0 0 0 8
7 0 35 0 0 0 0 0 0 0 0 0 0 0 0 0 0 0 0 0 0 0 0 0 0 0 0 0 40 8
13 10 10 10 10 10 10 10 10 10 10 10 0 0 0 0 0 10 10 10 10 10 10 10 10 10 10 10 10 11